1111111111111111111111111111111111
1E000F000000F00C00000C00000F000001
1010010100100000101001000000010101
1010010010101010001001000000010101
1P0000000C00C000000F00000000F000C1
1111111111111111111111111111111111